NO ./path_to_the_north_texture
SO ./path_to_the_south_texture
WE ./path_to_the_west_texture
EA ./path_to_the_east_texture

F 220,100,0
C 225,30,0

MEDI ./cenas
AMMO ./tretas
ENEMY ./coisas
BULLET ./bro
GUN ./ya
DOOR ./tretas
EXIT ./cenas

        1111111111111111111111111
        100000000011000000Z000001
        10110000011100000ZZ100001
        100100000DDD00000Z1000001
111111111011000001110000000000001
100000000011000001110111110111111
11110111111111011100000010001
1111D111111111011101010010001
11000000110101011100000010001
1M000N00000000001100000010001
1A000000000000001101010010001
1100000111010101111101111000111
11110111 1110101 101111010001
11111111 1111111 111111111111

        