NO ./path_to_the_north_texture
SO ./path_to_the_south_texture
WE ./path_to_the_west_texture
EA ./path_to_the_east_texture

F 220,100,0
C 225,30,0

MEDI ./cenas
AMMO ./tretas
ENEMY ./coisas
BULLET ./bro
DOOR ./cenas
EXIT ./tretas
GUN ./ya

1111111
1000001
10111011
10101001
10111011
1E0D0Z1
1111111
